You wake up on a hard couch, feeling like you suddenly remember everything in your whole life in one staggeringly lucid moment. You realize you've been sleeping on your badge, and the indentation in your belly makes you feel like you've been punched in the gut.

Your phone buzzes to life with "CHIEF" displayed on its glowing face.

Detective
An Interactive Fiction by Andrew Nelson
Release 1 / Serial number 111225 / Inform 7 build 6G60 (I6/v6.32 lib 6/12N) SD

Break Room (on the couch)
The detective's office breakroom has barely enough space for the filth and mice it is infested with. You hear phones ringing and general commotion through the cheap, thin door to the north.

You can see your phone here.

>hi
That's not a verb I recognise.

* * *

>awake
The dreadful truth is, this is not a dream.

>awaken
The dreadful truth is, this is not a dream.

>wake up
The dreadful truth is, this is not a dream.

* * *

>go
You'll have to say which compass direction to go in.

* * *

>enter ambulance
You can't see any such thing.

>look
Ambulance
Your chest is so tight, it's as if it will collapse into itself. Through a mouth like cotton you try to make a sound while blurry, bluish figures in this bright yet small room flail around you.

 "Wait, something fell off the gurney.. it's a ring," the figure says, now coming slightly more into focus. You notice the beeping noise again, this time louder, more sporadic. Your hand feels lighter... you feel lighter...

* * *

>test me
>--> No test scripts exist for this game.

I beg your pardon?

>do
That's not a verb I recognise.

>go
You'll have to say which compass direction to go in.

>n
You can't go that way.

>e
You can't go that way.

>s
That's the road.

>w
The fence disagrees.

* * *

>i
You are carrying:
  Ring (being worn)

>holding
That's not a verb I recognise.

>ring
That's not a verb I recognise.

>Ring
That's not a verb I recognise.

>examine Ring
You can't see any such thing.

>drop Ring
You can't see any such thing.

>drop ring
You can't see any such thing.

* * *

>i
You are carrying:
  Ring (being worn)

>drop ring
Dropped.

>look
Apartment
Your fresh-out-of-the-academy apartment is just enough space for the mice it is infested with.

You can see RIng here.

>take ring
Taken.

>i
You are carrying:
  RIng

>look
Apartment
Your fresh-out-of-the-academy apartment is just enough space for the mice it is infested with.

>Well actually, my original design was that you're a homicide detective with the power to see into the emotional value of objects (hold something special to someone, and you go back to a time when it was very emotionally tagged
You seem to want to talk to someone, but I can't see whom.

>Talk to officer
That's not a verb I recognise.

>Speak with Officer
(to yourself)
There is no reply.

* * *

>wake up
The dreadful truth is, this is not a dream.

>Awake
The dreadful truth is, this is not a dream.

* * *

>look
Break Room (on the couch)
You lie on the couch in the detective's office breakroom, which barely has enough space for the mice it is infested with. Your phone buzzes to life with "CHIEF" displayed on its glowing face.

You wish you could wake up next to something prettier.

>go east
(first getting off the couch)
You can't go that way.

>go west
You can't go that way.

>go south
You can't go that way.

>go north
Office
Walking out of the little room, you are greeted by several desks piled with phones and paperwork, which their human counterparts are busily shuffling around.

* * *

>look
Break Room (on the couch)
You lie on the couch in the detective's office breakroom, which barely has enough space for the mice it is infested with. Your phone buzzes to life with "CHIEF" displayed on its glowing face.

You wish you could wake up next to something prettier.

>answer phone
(to yourself)
There is no reply.

* * *

>look
Break Room (on the couch)
You lie on the couch in the detective's office breakroom, which barely has enough space for the mice it is infested with. Your phone buzzes to life with "CHIEF" displayed on its glowing face.

You wish you could wake up next to something prettier.

>examine filth
Your inconsistent 4-hour sleep schedules and round-the-clock detective work prevent you from finding much time to clean.

>examine bed
All you could fit was a matress on the floor.

* * *

>look
Break Room (on the couch)
You lie on the couch in the detective's office breakroom, which barely has enough space for the mice it is infested with. Your phone buzzes to life with "CHIEF" displayed on its glowing face.

You wish you could wake up next to something prettier.

>examine bed
You can't see any such thing.

* * *

>answer phone
(to yourself)
The chief detective is on the other end with new orders: "We need you on-scene at a distress call from 2578 Round Way. Possible kidnapping. Be there asap."

And with that the grizzled, curt man of 60 hangs up; yet you can almost feel him staring at you with his steely eyes if you don't get moving immediately.

>get up
But you aren't in anything at the moment.

* * *

>answer phone
(to yourself)
The chief detective is on the other end with new orders: "We need you on-scene at a distress call from 2578 Round Way. Possible kidnapping. Be there asap."

And with that the grizzled, curt man of 60 hangs up; yet you can almost feel him staring at you with his steely eyes if you don't get moving immediately.

>go north
(first getting off the couch)

Office
You are greeted by several desks piled with phones and paperwork, which their human counterparts are busily shuffling around. The break room is to the south, and the front door to the parking lot is to the east.

You can see Detective Tim here.

>go east
Parking Lot
Time to go to your assignment.

You can see a squad car (in which is Laptop) here.

>get in car
You get into the squad car.

In the squad car you can see Laptop.

>use laptop
That's not a verb I recognise.

>examine laptop
Open your laptop to check directions, databases, and other important stuff.

>open laptop
You plug the address in, and get directions to the assignment. Time to move out!

Driveway
The owners must be pretty wealthy, you think as you pull into the driveway of a fortress-like mansion. The officer on duty is in his squad car here, too.

Sitting in his squad car, the officer looks like he was bored waiting for you.

* * *

>get in car
You get into the squad car.

In the squad car you can see Laptop.

>open laptop
You plug the address in, and get directions to the assignment. Time to move out!

>Move out
You must name something more substantial.

* * *

>open laptop
You plug the address in, and get directions to the assignment. Time to move out!

>drive
Driveway
The owners must be pretty wealthy, you think as you pull into the driveway of a fortress-like mansion with a strong-looking gate. The officer on duty is in his squad car here, too.

You can see Officer Bigby here.

>examine officer bigby
Sitting in his squad car, the officer looks like he was bored waiting for you.

>talk to officer bigby
He let you konw that he couldn't find anything, but you might want to take a look around the yard and inside to figure out why the distress call went out in the first place.

>look
Driveway
The yard is to the east, and the front door is to the north. The owners must be pretty wealthy, you think as you pull into the driveway of a fortress-like mansion with a strong-looking gate. The officer on duty is in his squad car here, too.

You can see Officer Bigby here.

>go east
Yard
You're in the front yard. In the corner you see a vegetable and herb garden.

>examine garden
The soil seems disturbed, and a few plants are bent. Hiding behind this and the shrubbery would provide sufficient cover for a peeping tom.

>examine the garden
The soil seems disturbed, and a few plants are bent. Hiding behind this and the shrubbery would provide sufficient cover for a peeping tom.

>look
Yard
You're in the front yard. In the corner you see a vegetable and herb garden.

>go north
Foyer
"Definitely a ritzy place," you think as you trip over a box on the floor. There is some noise coming from the north.

>go norht
You can't see any such thing.

>go north
You can't go that way.

* * *

>go east
Parking Lot
Time to go to your assignment.

You can see a squad car (in which is Laptop) here.

>go south
You may be in fresh-out-of-the-academy athletic condition, but maybe driving would be a better idea.

>get in car
You get into the squad car.

In the squad car you can see Laptop.

>go south
You may be in fresh-out-of-the-academy athletic condition, but maybe driving would be a better idea.

>drive
Driveway
The owners must be pretty wealthy, you think as you pull into the driveway of a fortress-like mansion with a strong-looking gate. The officer on duty is in his squad car here, too.

You can see Officer Bigby here.

>talk to officer bigby
He lets you know that he couldn't find anything, but you might want to take a look around the yard and inside to check for signs of disturbance and what may have happened.

>look
Driveway
The yard is to the east, and the front door is to the north. The owners must be pretty wealthy, you think as you pull into the driveway of a fortress-like mansion with a strong-looking gate. The officer on duty is in his squad car here, too.

You can see Officer Bigby here.

>go north
You're on the case, you can't leave!

>go west
You can't go that way.

* * *

>go south
You can't go that way.

>go east
Yard
You're in the front yard. In the east corner you see a vegetable and herb garden, and the entrance to the mansion is to the north.

>go east
Garden
The soil seems disturbed, and a few plants are bent. Hiding behind this and the shrubbery would provide sufficient cover for a peeping tom. You notice the window here is broken and blood drips down the wall from it. A chewed tennis ball lies at your feet as a dog growls from around the corner at you. It doesn't look happy.

You can see Ball here.

>go west
The dog comes closer and closer to you.

>go east
You can't go that way.

>go south
You can't go that way.

>go north
You can't go that way.

>go west
The dog comes closer and closer to you.

>throw ball
The dog lightens up and happily chases the ball into the backyard. You might want to get inside in case he wants to play with the next guy who comes near the window.

>take ball
You can't see any such thing.

>go west
Yard
You're in the front yard. In the east corner you see a vegetable and herb garden, and the entrance to the mansion is to the north.

>throw ball
You can't see any such thing.

>go north
Foyer
You enter the mansion. "Definitely a ritzy place," you think as you trip over something fancy looking. The exit is to the south, the main room to the north, and the kitchen to the east.

>examine box
You can't see any such thing.

>examine expensive object
I only understood you as far as wanting to examine Expensive thing.

>look
Foyer
 The exit is to the south, the main room to the north, and the kitchen to the east.

>go east
Kitchen
The broken window is rather bloody and you see a trail running to the main room. It appears the person had some pretty hard times breaking in. I suspect it was the guard dog.

>look
Kitchen
The broken window is rather bloody and you see a trail running to the main room. It appears the person had some pretty hard times breaking in. I suspect it was the guard dog.

>go west
Foyer
 The exit is to the south, the main room to the north, and the kitchen to the east.

>go north
Main room
The space is lavishly decorated, and high-quality furniture graces the room with class. There is a chandelier on the ceiling and a large bookcase to the east. The only problem is that there's empty spaces everywhere, where it appears someone has taken the valuable objects that should be there.

You can see a bookcase here.

>examine bookcase
One section of books on the bookcase is odd-looking.

* * *

>go north
(first getting off the couch)

Office
You are greeted by several desks piled with phones and paperwork, which their human counterparts are busily shuffling around. The break room is to the south, and the front door to the parking lot is to the east.

You can see Detective Tim here.

>examine
(Ring)
You see nothing special about Ring.

* * *

>answer phone
(to yourself)
The chief detective is on the other end with new orders: "We need you on-scene at a distress call from 2578 Round Way. Possible kidnapping. Be there asap."

And with that the grizzled, curt man of 60 hangs up; yet you can almost feel him staring at you with his steely eyes if you don't get moving immediately.

>examine phone
You see nothing special about your phone.

>look
Break Room
You lie on the couch in the detective's office breakroom, which barely has enough space for the mice it is infested with. Your phone buzzes to life with "CHIEF" displayed on its glowing face.

You wish you could wake up next to something prettier.

>examine door
You can't see any such thing.

>go north
Office
Walking out of the little room, you are greeted by several desks piled with phones and paperwork, which their human counterparts are busily shuffling around.

>go east
You can't go that way.

>go west
The fence disagrees.

>go south
That's the road.

>go north
You can't go that way.